3 13 31
###############################
#p   ** ** 2  *               #
# # # #*# # # # # # # # # # # #
#*     ** * *  *   * ** 3 *   #
# # # # # #*# # # # # # #*# # #
#*   *b*    *** * x **        #
# # # # # # # # # # # # # #*# #
#    *     *        *    **  4#
# #*# # #*#*#*#*# # # # # #*# #
#        *   * *    *   *     #
#*# # # # # # # # # # #*# # #*#
# *    * ** 1  ** ***         #
###############################