5 13 31
###############################
#p * *3       *  ** * *      *#
# # # # #*# # # # # # # # #*# #
#    * * *** **  5   *    **  #
# #*# # # # # # #b# # # # # #*#
#          *     **      *  **#
# # #*# # # # # #*#*#*#s# # # #
#   *        *   * *x* *   4  #
# # #f# #*# # # # # # #*# #*# #
#   ****         *2           #
# # # # # # # # # #*# # # # #*#
#  ** *5  *    1              #
###############################