4 13 31
###############################
#p    * **    *       5       #
# # # #*# # # # # # # # # # # #
#      ** * *  *   * ** 2 *   #
# # # # # #*# # # # # # #*# # #
#*   * *    *f* *   **        #
# # # # # # # # # # # # # #*# #
#    *     *        *    **  3#
# #s# # #*#*#*#*# # # # # #*# #
#        * 4 * *    *   *     #
#*# # # # # # # # # # #*# # #*#
#x*    * **    ** ***     1   #
###############################