2 13 31
###############################
#p   *        *  ** * *      *#
# # # # #*# # #*# # # # # #*# #
#    * * *** **      *    **  #
# #*# # # # #3# #f#1# # # # #*#
#          *     **      *  **#
# # #*# # # # # #*#*#*#*# # # #
#  2*        *   * *x* *      #
# # # # #*# # # # # # #*# #*# #
#   ****         *1           #
# # # # # # # # # #*# # # # #*#
#  ** *   *                   #
###############################